####################
#__________________#
#__________________#
#_______#########__#
#____________#_____#
#____________#_____#
#____________#_____#
#____________#_____#
#__________________#
#___##########_____#
#__________________#
#________1_________#
#__________________#
#________#_________#
#________#_________#
#________#_________#
#___2____#_________#
#________#####_____#
#________#_________#
#________#_________#
#__________________#
####################
